name	seq
SARS-CoV-2_1_LEFT	GGCAAACCACGCGAACAAATAG
SARS-CoV-2_1_RIGHT	TGAGGATCTGAAAACTTTGTCAGGG
SARS-CoV-2_2_LEFT	GTGATGTTCTTGTTAACAACTAAACGAAC
SARS-CoV-2_2_RIGHT	GTAGCGTTATTAACAATAAGTAGGGACTG
SARS-CoV-2_3_LEFT	AGAGGCTGGATTTTTGGTACTACT
SARS-CoV-2_3_RIGHT	ACCTAGTGATGTTAATACCTATTGGCA
SARS-CoV-2_4_LEFT	TGGACCTTGAAGGAAAACAGGG
SARS-CoV-2_4_RIGHT	TGATAGATTCCTTTTTCTACAGTGAAGGA
SARS-CoV-2_5_LEFT	GAAAATGGAACCATTACAGATGCTGT
SARS-CoV-2_5_RIGHT	TTTGCCCTGGAGCGATTTGT
SARS-CoV-2_6_LEFT	GCTGATTATTCTGTCCTATATAATTCCGC
SARS-CoV-2_6_RIGHT	GTTGGAAACCATATGATTGTAAAGGAAAG
SARS-CoV-2_7_LEFT	CAAACCTTTTGAGAGAGATATTTCAACTGA
SARS-CoV-2_7_RIGHT	CACTGACACCACCAAAAGAACATG
SARS-CoV-2_8_LEFT	CTGAGTCTAACAAAAAGTTTCTGCCTT
SARS-CoV-2_8_RIGHT	GGATTGACTAGCTACACTACGTGC
SARS-CoV-2_9_LEFT	ACCCATTGGTGCAGGTATATGC
SARS-CoV-2_9_RIGHT	CCAAAATCTTTAATTGGTGGTGTTTTGT
SARS-CoV-2_10_LEFT	CCGTGCTTTAACTGGAATAGCTG
SARS-CoV-2_10_RIGHT	GCAAATGGTATTTGTAATGCAGCAC
SARS-CoV-2_11_LEFT	TGCTCAATACACTTCTGCACTGT
SARS-CoV-2_11_RIGHT	TGAAGTCTGCCTGTGATCAACC
SARS-CoV-2_12_LEFT	TGCACAAGCTTTAAACACGCTT
SARS-CoV-2_12_RIGHT	CACGAGGAAAGTGTGCTTTTCC
SARS-CoV-2_13_LEFT	GCATGTGACTTATGTCCCTGCA
SARS-CoV-2_13_RIGHT	AGATTCATTTAAATTCTTGGCAACCTCA
SARS-CoV-2_14_LEFT	GTTGATTTAGGTGACATCTCTGGCA
SARS-CoV-2_14_RIGHT	AGCATCCTTGATTTCACCTTGCT
